NO textures/no.xpm
SO textures/so.xpm
WE textures/we.xpm
EA textures/ea.xpm
F 220,100,0
C 100,100,100

11111111
 10000001111
100011110011
10001 101001
10N01 101011
11111 11111