NO textures/no.xpm
SO textures/so.xpm
WE textures/we.xpm
EA textures/ea.xpm
F 220,100,0
C 100,100,100

11111
1N0N1
10001
11111