
WE textures/we.xpm
EA textures/ea.xpm
F 220,100,0
NO textures/no.xpm
C 100,100,200
SO textures/so.xpm


11111
10N01
1A001
11111