NO textures/no.xpm
SO textures/so.xpm
WE textures/we.xpm
EA textures/ea.xpm
F 220,100,0
C 100,100,100


1111111
1N00001
1001
111111