NO textures/no.xpm
SO textures/so.xpm
WE textures/we.xpm
EA textures/ea.xpm
F 220,100,0
C 100,100,100

11111111
10000001111
10001110001
10001010001
10001110001
11111N11111