NO textures/no.xpm
SO textures/so.xpm
WE missing/we.xpm
EA textures/ea.xpm
F 220,100,0
C 100,100,100

1111
1N01
1001
1111