NO textures/no.xpm
SO textures/so.xpm
WE textures/we.xpm
EA textures/ea.xpm
F 15, 22, 30
C 20, 24, 48

111111111
110000001111
100011110011
10001 101001
10N01 101011
11111 11111
