NO textures/no.xpm
SO textures/so.xpm
WE textures/we.xpm
EA textures/ea.xpm
F 15, 22, 30
C 20, 24, 48

  1111
  1N01
  1001
  1111
